7
10
15
20
111112111111111
100000000000001
110111010110101
100100010000101
110001110101101
111101100001001
101000112101011
100010111100001
101110000101011
111000000111111
111010000100011
100000000001001
110111110100001
100100010000001
110001110101101
111101100001001
101000100101011
100010111100001
101010000101011
111211111111111