18
18
25
25
1111111111111111111111211
1000100000000011110001011
1111111111111000000000001
1000000000000010000000001
1011111111111111100001111
1011011000010011100001111
1010001101010110001111011
1000101111000011100011001
1011100001010000110100110
1110000001111110000001000
1110100001000000000001111
1000000000010011100001101
1101111101000010101100000
1001000100000010100110001
1100011101011010110000001
1111011000010000100011010
1010001001010110000011100
1000101111000011100000100
1010100001010110110101001
1110000000011110000000000
1000110000100000100011101
1001001000110000000100001
1001000110011111000000001
1111111111000010000001111
1111111111111111111111111
1111111111111111111111111