18
18
50
50
11111111111111111111111111111111111111111111111111
10001000000000111100010001000111000101001110000100
11111111111110000000000011001000110001100000011111
10000000000000100000000000000000000000000000000001
10111111111111111000000000000000000001000100000011
10110110000100111000011000100000000000011110000011
10100011010101100011110110000000000000000000111111
10001011110000111000110011110000100000111111111111
10111000010100001101001101111100001100011111111111
11100000011111100000010000000000001100000011000000
11101000010000000000011111111111111111111000000001
10000000000100111000000000000000000000111111000001
11011111010000101011000001111111100001111111100011
10010001000000101001100011111111111111111111100111
11000111010110101100000011111111111000001111101111
11110110000100001000110101111111111111111111111111
10100010010101100000111001111111111111111111111111
10001011110000111000001001111111111111111111111111
10101000010101101101010011111000000000000011100111
11100000000111100000000001000001000111000011111111
10001100001000001000111000000111000001111111111111
10010010001100000001000011111111000001001001111111
10010001100111110000000011100001011111000000000111
11111111110000100000011000000000000000000000000011
11111111110000111111111110000000000000000000000011
11111111000000000001110000000000011111111111111111
10001000000000111100010001000111000101001110000100
11111111111110000000000011001000110001100000011111
10000000000000100000000000000000000000000000000001
10111111111111111000000000000000000001000100000011
10110110000100111000011000100000000000011110000011
10100011010101100011110110000000000000000000111111
10001011110000111000110011110000100000111111111111
10111000010100001101001101111100001100011111111111
11100000011111100000010000000000001100000011000000
11101000010000000000011111111111111111111000000001
10000000000100111000000000000000000000111111000001
11011111010000101011000001111111100001111111100011
10010001000000101001100011111111111111111111100111
11000111010110101100000011111111111000001111101111
11110110000100001000110101111111111111111111111111
10100010010101100000111001111111111111111111111111
10001011110000111000001001111111111111111111111111
10101000010101101101010011111000000000000011100111
11100000000111100000000001000001111111000011111111
10001100001000001000111000000111111111111111111111
10010010001100000001000011111111000001001001111111
10010001100111110000000011100001011111000000000111
11111111110000100000011000000000000000000000000011
11111111111111111111111110000000000000000000000011
