13
1
15
20
111111111111111
100000000000001
101111111111111
101111111111111
101111111111111
101111111111111
101111111111111
101111111111111
101111111111111
101111111111111
101111111111111
101111111111111
101111111111111
101111111111111
101111111111111
10000000000000-1
111111111111111
111111111111111
111111111111111
111111111111111